age	agir+V+PRS+3+SG
agem	agir+V+PRS+3+PL
ages	agir+V+PRS+2+SG
agia	agir+V+IMPF+3+SG
agia	agir+V+IMPF+1+SG
agiam	agir+V+IMPF+3+PL
agias	agir+V+IMPF+2+SG
agimos	agir+V+PRS+1+PL
agirei	agir+V+FUT+1+SG
agireis	agir+V+FUT+2+PL
agiremos	agir+V+FUT+1+PL
agiria	agir+V+COND+3+SG
agiria	agir+V+COND+1+SG
agiriam	agir+V+COND+3+PL
agirias	agir+V+COND+2+SG
agirá	agir+V+FUT+3+SG
agirás	agir+V+FUT+2+SG
agirão	agir+V+FUT+3+PL
agiríamos	agir+V+COND+1+PL
agiríeis	agir+V+COND+2+PL
agis	agir+V+PRS+2+PL
agíamos	agir+V+IMPF+1+PL
agíeis	agir+V+IMPF+2+PL
aja	agir+V+SBJR+3+SG
aja	agir+V+SBJR+1+SG
ajais	agir+V+SBJR+2+PL
ajam	agir+V+SBJR+3+PL
ajamos	agir+V+SBJR+1+PL
ajas	agir+V+SBJR+2+SG
ajo	agir+V+PRS+1+SG
coçáveis	coçar+V+IMPF+2+PL
coçávamos	coçar+V+IMPF+1+PL
coço	coçar+V+PRS+1+SG
coçavas	coçar+V+IMPF+2+SG
coçavam	coçar+V+IMPF+3+PL
coçava	coçar+V+IMPF+1+SG
coçava	coçar+V+IMPF+3+SG
coças	coçar+V+PRS+2+SG
coçaríeis	coçar+V+COND+2+PL
coçaríamos	coçar+V+COND+1+PL
coçarão	coçar+V+FUT+3+PL
coçarás	coçar+V+FUT+2+SG
coçará	coçar+V+FUT+3+SG
coçarias	coçar+V+COND+2+SG
coçariam	coçar+V+COND+3+PL
coçaria	coçar+V+COND+1+SG
coçaria	coçar+V+COND+3+SG
coçaremos	coçar+V+FUT+1+PL
coçareis	coçar+V+FUT+2+PL
coçarei	coçar+V+FUT+1+SG
coçamos	coçar+V+PRS+1+PL
coçam	coçar+V+PRS+3+PL
coçais	coçar+V+PRS+2+PL
coça	coçar+V+PRS+3+SG
coces	coçar+V+SBJR+2+SG
cocemos	coçar+V+SBJR+1+PL
cocem	coçar+V+SBJR+3+PL
coceis	coçar+V+SBJR+2+PL
coce	coçar+V+SBJR+1+SG
coce	coçar+V+SBJR+3+SG
pagáveis	pagar+V+IMPF+2+PL
pagávamos	pagar+V+IMPF+1+PL
pagues	pagar+V+SBJR+2+SG
paguemos	pagar+V+SBJR+1+PL
paguem	pagar+V+SBJR+3+PL
pagueis	pagar+V+SBJR+2+PL
pague	pagar+V+SBJR+1+SG
pague	pagar+V+SBJR+3+SG
pago	pagar+V+PRS+1+SG
pagavas	pagar+V+IMPF+2+SG
pagavam	pagar+V+IMPF+3+PL
pagava	pagar+V+IMPF+1+SG
pagava	pagar+V+IMPF+3+SG
pagas	pagar+V+PRS+2+SG
pagaríeis	pagar+V+COND+2+PL
pagaríamos	pagar+V+COND+1+PL
pagarão	pagar+V+FUT+3+PL
pagarás	pagar+V+FUT+2+SG
pagará	pagar+V+FUT+3+SG
pagarias	pagar+V+COND+2+SG
pagariam	pagar+V+COND+3+PL
pagaria	pagar+V+COND+1+SG
pagaria	pagar+V+COND+3+SG
pagaremos	pagar+V+FUT+1+PL
pagareis	pagar+V+FUT+2+PL
pagarei	pagar+V+FUT+1+SG
pagamos	pagar+V+PRS+1+PL
pagam	pagar+V+PRS+3+PL
pagais	pagar+V+PRS+2+PL
paga	pagar+V+PRS+3+SG
seca	secar+V+PRS+3+SG
secais	secar+V+PRS+2+PL
secam	secar+V+PRS+3+PL
secamos	secar+V+PRS+1+PL
secarei	secar+V+FUT+1+SG
secareis	secar+V+FUT+2+PL
secaremos	secar+V+FUT+1+PL
secaria	secar+V+COND+3+SG
secaria	secar+V+COND+1+SG
secariam	secar+V+COND+3+PL
secarias	secar+V+COND+2+SG
secará	secar+V+FUT+3+SG
secarás	secar+V+FUT+2+SG
secarão	secar+V+FUT+3+PL
secaríamos	secar+V+COND+1+PL
secaríeis	secar+V+COND+2+PL
secas	secar+V+PRS+2+SG
secava	secar+V+IMPF+3+SG
secava	secar+V+IMPF+1+SG
secavam	secar+V+IMPF+3+PL
secavas	secar+V+IMPF+2+SG
seco	secar+V+PRS+1+SG
secávamos	secar+V+IMPF+1+PL
secáveis	secar+V+IMPF+2+PL
seque	secar+V+SBJR+3+SG
seque	secar+V+SBJR+1+SG
sequeis	secar+V+SBJR+2+PL
sequem	secar+V+SBJR+3+PL
sequemos	secar+V+SBJR+1+PL
seques	secar+V+SBJR+2+SG
teço	tecer+V+PRS+1+SG
teças	tecer+V+SBJR+2+SG
teçamos	tecer+V+SBJR+1+PL
teçam	tecer+V+SBJR+3+PL
teçais	tecer+V+SBJR+2+PL
teça	tecer+V+SBJR+1+SG
teça	tecer+V+SBJR+3+SG
tecíeis	tecer+V+IMPF+2+PL
tecíamos	tecer+V+IMPF+1+PL
tecias	tecer+V+IMPF+2+SG
teciam	tecer+V+IMPF+3+PL
tecia	tecer+V+IMPF+1+SG
tecia	tecer+V+IMPF+3+SG
teces	tecer+V+PRS+2+SG
teceríeis	tecer+V+COND+2+PL
teceríamos	tecer+V+COND+1+PL
tecerão	tecer+V+FUT+3+PL
tecerás	tecer+V+FUT+2+SG
tecerá	tecer+V+FUT+3+SG
tecerias	tecer+V+COND+2+SG
teceriam	tecer+V+COND+3+PL
teceria	tecer+V+COND+1+SG
teceria	tecer+V+COND+3+SG
teceremos	tecer+V+FUT+1+PL
tecereis	tecer+V+FUT+2+PL
tecerei	tecer+V+FUT+1+SG
tecemos	tecer+V+PRS+1+PL
tecem	tecer+V+PRS+3+PL
teceis	tecer+V+PRS+2+PL
tece	tecer+V+PRS+3+SG
compres	comprar+V+SBJR+2+SG
compremos	comprar+V+SBJR+1+PL
comprem	comprar+V+SBJR+3+PL
compreis	comprar+V+SBJR+2+PL
compre	comprar+V+SBJR+1+SG
compre	comprar+V+SBJR+3+SG
vendas	vender+V+SBJR+2+SG
vendamos	vender+V+SBJR+1+PL
vendam	vender+V+SBJR+3+PL
vendais	vender+V+SBJR+2+PL
venda	vender+V+SBJR+1+SG
venda	vender+V+SBJR+3+SG
compro	comprar+V+PRS+1+SG
compras	comprar+V+PRS+2+SG
compramos	comprar+V+PRS+1+PL
compram	comprar+V+PRS+3+PL
comprais	comprar+V+PRS+2+PL
compra	comprar+V+PRS+3+SG
vendo	vender+V+PRS+1+SG
vendes	vender+V+PRS+2+SG
vendemos	vender+V+PRS+1+PL
vendem	vender+V+PRS+3+PL
vendeis	vender+V+PRS+2+PL
vende	vender+V+PRS+3+SG
compraríeis	comprar+V+COND+2+PL
compraríamos	comprar+V+COND+1+PL
comprarias	comprar+V+COND+2+SG
comprariam	comprar+V+COND+3+PL
compraria	comprar+V+COND+1+SG
compraria	comprar+V+COND+3+SG
venderíeis	vender+V+COND+2+PL
venderíamos	vender+V+COND+1+PL
venderias	vender+V+COND+2+SG
venderiam	vender+V+COND+3+PL
venderia	vender+V+COND+1+SG
venderia	vender+V+COND+3+SG
compráveis	comprar+V+IMPF+2+PL
comprávamos	comprar+V+IMPF+1+PL
compravas	comprar+V+IMPF+2+SG
compravam	comprar+V+IMPF+3+PL
comprava	comprar+V+IMPF+1+SG
comprava	comprar+V+IMPF+3+SG
vendíeis	vender+V+IMPF+2+PL
vendíamos	vender+V+IMPF+1+PL
vendias	vender+V+IMPF+2+SG
vendiam	vender+V+IMPF+3+PL
vendia	vender+V+IMPF+1+SG
vendia	vender+V+IMPF+3+SG
comprarão	comprar+V+FUT+3+PL
comprarás	comprar+V+FUT+2+SG
comprará	comprar+V+FUT+3+SG
compraremos	comprar+V+FUT+1+PL
comprareis	comprar+V+FUT+2+PL
comprarei	comprar+V+FUT+1+SG
venderão	vender+V+FUT+3+PL
venderás	vender+V+FUT+2+SG
venderá	vender+V+FUT+3+SG
venderemos	vender+V+FUT+1+PL
vendereis	vender+V+FUT+2+PL
venderei	vender+V+FUT+1+SG
